#######  #
#S   ##  #
#       ##
#  # #####
# ## #  ##
# ## #  E#
##########
